{
  "width": 20,
  "height": 11,
  "tileSize": 16,
  "layers": [
    {
      "name": "solid",
      "type": "solid",
      "data": [
        0,0,0,0,0,0,0,0,0,0,0,0,0,0,0,0,0,0,0,0,
        0,0,0,0,0,0,0,0,0,0,0,0,0,0,0,0,0,0,0,0,
        0,0,0,0,0,0,0,0,0,0,0,0,0,0,0,0,0,0,0,0,
        0,0,0,0,1,1,1,1,1,0,0,1,1,1,1,1,0,0,0,0,
        0,0,0,0,0,0,0,0,0,0,0,0,0,0,0,0,0,0,0,0,
        0,0,0,1,1,1,1,1,0,0,0,0,1,1,1,1,1,0,0,0,
        0,0,0,0,0,0,0,0,0,0,0,0,0,0,0,0,0,0,0,0,
        0,0,1,1,1,1,1,0,0,0,0,0,0,1,1,1,1,1,0,0,
        0,0,0,0,0,0,0,0,0,0,0,0,0,0,0,0,0,0,0,0,
        0,0,0,0,0,0,0,0,0,0,0,0,0,0,0,0,0,0,0,0,
        1,1,1,1,1,1,1,1,1,1,1,1,1,1,1,1,1,1,1,1
      ]
    },
    {
      "name": "paint",
      "type": "paint",
      "data": [
        0,0,0,0,0,0,0,0,0,0,0,0,0,0,0,0,0,0,0,0,
        0,0,0,0,0,0,0,0,0,0,0,0,0,0,0,0,0,0,0,0,
        0,0,0,0,0,0,0,0,0,0,0,0,0,0,0,0,0,0,0,0,
        0,0,0,0,1,1,1,1,1,0,0,1,1,1,1,1,0,0,0,0,
        0,0,0,0,0,0,0,0,0,0,0,0,0,0,0,0,0,0,0,0,
        0,0,0,1,1,1,1,1,0,0,0,0,1,1,1,1,1,0,0,0,
        0,0,0,0,0,0,0,0,0,0,0,0,0,0,0,0,0,0,0,0,
        0,0,1,1,1,1,1,0,0,0,0,0,0,1,1,1,1,1,0,0,
        0,0,0,0,0,0,0,0,0,0,0,0,0,0,0,0,0,0,0,0,
        0,0,0,0,0,0,0,0,0,0,0,0,0,0,0,0,0,0,0,0,
        1,1,1,1,1,1,1,1,1,1,1,1,1,1,1,1,1,1,1,1
      ]
    },
    {
      "name": "ladder",
      "type": "ladder",
      "data": [
        0,0,0,0,0,0,0,0,0,0,0,0,0,0,0,0,0,0,0,0,
        0,0,0,0,0,0,0,0,0,0,0,0,0,0,0,0,0,0,0,0,
        0,0,0,0,0,0,0,0,0,0,0,0,0,0,0,0,0,0,0,0,
        0,0,0,0,0,0,1,0,0,0,0,0,0,1,0,0,0,0,0,0,
        0,0,0,0,0,0,1,0,0,0,0,0,0,1,0,0,0,0,0,0,
        0,0,0,0,0,0,1,0,0,0,0,0,0,1,0,0,0,0,0,0,
        0,0,0,0,0,0,1,0,0,0,0,0,0,1,0,0,0,0,0,0,
        0,0,0,0,0,0,1,0,0,0,0,0,0,1,0,0,0,0,0,0,
        0,0,0,0,0,0,1,0,0,0,0,0,0,1,0,0,0,0,0,0,
        0,0,0,0,0,0,1,0,0,0,0,0,0,1,0,0,0,0,0,0,
        0,0,0,0,0,0,1,0,0,0,0,0,0,1,0,0,0,0,0,0
      ]
    },
    {
      "name": "decor",
      "type": "decor",
      "data": []
    }
  ],
  "entities": [
    {"type": "playerStart", "x": 32, "y": 160},
    {"type": "enemy", "x": 72, "y": 112, "patrolMinX": 40, "patrolMaxX": 104},
    {"type": "enemy", "x": 232, "y": 80, "patrolMinX": 200, "patrolMaxX": 264},
    {"type": "enemy", "x": 104, "y": 48, "patrolMinX": 72, "patrolMaxX": 136},
    {"type": "powerup", "kind": "shovel", "x": 88, "y": 80},
    {"type": "powerup", "kind": "pickaxe", "x": 216, "y": 48}
  ]
}
