{
  "width": 20,
  "height": 11,
  "tileSize": 16,
  "layers": [
    {
      "name": "solid",
      "type": "solid",
      "data": [
        0,0,0,0,0,0,0,0,0,0,0,0,0,0,0,0,0,0,0,0,
        0,0,0,0,0,0,0,0,0,1,1,0,0,0,0,0,0,0,0,0,
        0,0,0,0,0,0,1,1,1,1,1,1,1,1,0,0,0,0,0,0,
        0,0,0,0,1,1,1,1,1,1,1,1,1,1,1,1,1,0,0,0,
        0,1,1,1,1,1,1,1,1,0,0,0,1,1,1,1,1,1,1,0,
        0,0,0,1,1,1,1,1,1,1,1,1,1,1,1,1,1,0,0,0,
        1,1,1,1,1,1,1,1,1,0,0,0,1,1,1,1,1,1,1,1,
        0,0,1,1,1,1,1,1,1,1,1,1,1,1,1,1,1,1,0,0,
        1,1,1,1,1,1,1,1,1,0,0,0,1,1,1,1,1,1,1,1,
        1,1,1,1,1,1,1,1,1,1,0,1,1,1,1,1,1,1,1,1,
        1,1,1,1,1,1,1,1,1,1,1,1,1,1,1,1,1,1,1,1
      ]
    },
    {
      "name": "paint",
      "type": "paint",
      "data": [
        0,0,0,0,0,0,0,0,0,0,0,0,0,0,0,0,0,0,0,0,
        0,0,0,0,0,0,0,0,0,1,1,0,0,0,0,0,0,0,0,0,
        0,0,0,0,0,0,1,1,1,1,1,1,1,1,0,0,0,0,0,0,
        0,0,0,0,1,1,1,1,1,1,1,1,1,1,1,1,1,0,0,0,
        0,1,1,1,1,1,1,1,1,0,0,0,1,1,1,1,1,1,1,0,
        0,0,0,1,1,1,1,1,1,1,1,1,1,1,1,1,1,0,0,0,
        1,1,1,1,1,1,1,1,1,0,0,0,1,1,1,1,1,1,1,1,
        0,0,1,1,1,1,1,1,1,1,1,1,1,1,1,1,1,1,0,0,
        1,1,1,1,1,1,1,1,1,0,0,0,1,1,1,1,1,1,1,1,
        1,1,1,1,1,1,1,1,1,1,0,1,1,1,1,1,1,1,1,1,
        1,1,1,1,1,1,1,1,1,1,1,1,1,1,1,1,1,1,1,1
      ]
    },
    {
      "name": "ladder",
      "type": "ladder",
      "data": [
        0,0,0,0,0,0,0,0,0,0,0,0,0,0,0,0,0,0,0,0,
        0,0,0,0,0,0,0,0,0,0,0,0,0,0,0,0,0,0,0,0,
        0,0,0,0,0,0,0,0,1,0,0,0,1,0,0,0,0,0,0,0,
        0,0,0,0,0,0,0,0,1,0,0,0,1,0,0,0,1,0,0,0,
        0,0,0,1,0,0,0,0,1,0,0,0,1,0,0,0,1,0,1,0,
        0,0,0,1,0,0,0,0,1,0,0,0,1,0,0,0,1,0,1,0,
        0,0,0,1,0,0,0,0,1,0,0,0,1,0,0,0,1,0,1,0,
        0,0,0,1,0,0,0,0,1,0,0,0,1,0,0,0,1,0,1,0,
        0,0,0,1,0,0,0,0,1,0,0,0,1,0,0,0,1,0,1,0,
        0,0,0,1,0,0,0,0,1,0,0,0,1,0,0,0,1,0,1,0,
        0,0,0,1,0,0,0,0,1,0,0,0,1,0,0,0,1,0,1,0
      ]
    },
    {
      "name": "decor",
      "type": "decor",
      "data": []
    }
  ],
  "entities": [
    {"type": "playerStart", "x": 24, "y": 160},
    {"type": "enemy", "x": 104, "y": 144, "patrolMinX": 56, "patrolMaxX": 152},
    {"type": "enemy", "x": 200, "y": 112, "patrolMinX": 136, "patrolMaxX": 248},
    {"type": "enemy", "x": 248, "y": 80, "patrolMinX": 200, "patrolMaxX": 264},
    {"type": "powerup", "kind": "shovel", "x": 120, "y": 108},
    {"type": "powerup", "kind": "pickaxe", "x": 168, "y": 44}
  ]
}
