{
  "width": 20,
  "height": 11,
  "tileSize": 16,
  "layers": [
    {
      "name": "solid",
      "type": "solid",
      "data": [
        0,0,0,0,0,0,0,0,0,0,0,0,0,0,0,0,0,0,0,0,
        0,0,0,0,0,0,0,0,0,0,0,0,0,0,0,0,0,0,0,0,
        0,0,0,0,0,0,0,0,0,0,0,0,0,0,0,0,0,0,0,0,
        0,0,0,0,0,0,0,0,0,0,0,0,0,0,0,0,0,0,0,0,
        1,1,0,1,1,1,1,1,1,0,1,1,1,1,0,1,1,1,1,1,
        0,0,0,0,0,0,0,0,0,0,0,0,0,0,0,0,0,0,0,0,
        1,1,0,1,1,1,1,1,0,0,0,0,1,1,0,1,1,1,1,1,
        0,0,0,0,0,0,0,0,0,0,0,0,0,0,0,0,0,0,0,0,
        0,0,0,1,1,1,1,1,1,0,1,1,1,1,0,1,1,1,0,0,
        1,1,0,1,1,1,0,0,0,1,1,1,1,1,0,0,0,1,1,1,
        1,1,1,1,1,1,1,1,1,1,1,1,1,1,1,1,1,1,1,1
      ]
    },
    {
      "name": "paint",
      "type": "paint",
      "data": [
        0,0,0,0,0,0,0,0,0,0,0,0,0,0,0,0,0,0,0,0,
        0,0,0,0,0,0,0,0,0,0,0,0,0,0,0,0,0,0,0,0,
        0,0,0,0,0,0,0,0,0,0,0,0,0,0,0,0,0,0,0,0,
        0,0,0,0,0,0,0,0,0,0,0,0,0,0,0,0,0,0,0,0,
        1,1,0,1,1,1,1,1,1,0,1,1,1,1,0,1,1,1,1,1,
        0,0,0,0,0,0,0,0,0,0,0,0,0,0,0,0,0,0,0,0,
        1,1,0,1,1,1,1,1,0,0,0,0,1,1,0,1,1,1,1,1,
        0,0,0,0,0,0,0,0,0,0,0,0,0,0,0,0,0,0,0,0,
        0,0,0,1,1,1,1,1,1,0,1,1,1,1,0,1,1,1,0,0,
        1,1,0,1,1,1,0,0,0,1,1,1,1,1,0,0,0,1,1,1,
        1,1,1,1,1,1,1,1,1,1,1,1,1,1,1,1,1,1,1,1
      ]
    },
    {
      "name": "ladder",
      "type": "ladder",
      "data": [
        0,0,0,0,0,0,0,0,0,0,0,0,0,0,0,0,0,0,0,0,
        0,0,0,0,0,0,0,0,0,0,0,0,0,0,0,0,0,0,0,0,
        0,0,0,0,0,0,0,0,0,0,0,0,0,0,0,0,0,0,0,0,
        0,0,0,0,0,0,0,0,0,0,0,0,0,0,0,0,0,0,0,0,
        0,0,1,0,0,0,0,0,0,1,0,0,0,0,1,0,0,0,0,0,
        0,0,1,0,0,0,0,0,0,1,0,0,0,0,1,0,0,0,0,0,
        0,0,1,0,0,0,0,0,0,1,0,0,0,0,1,0,0,0,0,0,
        0,0,1,0,0,0,0,0,0,1,0,0,0,0,1,0,0,0,0,0,
        0,0,1,0,0,0,0,0,0,1,0,0,0,0,1,0,0,0,0,0,
        0,0,1,0,0,0,0,0,0,1,0,0,0,0,1,0,0,0,0,0,
        0,0,1,0,0,0,0,0,0,1,0,0,0,0,1,0,0,0,0,0
      ]
    },
    {
      "name": "decor",
      "type": "decor",
      "data": []
    }
  ],
  "entities": [
    {
      "type": "playerStart",
      "x": 24,
      "y": 144
    },
    {
      "type": "enemy",
      "x": 72,
      "y": 144,
      "patrolMinX": 56,
      "patrolMaxX": 88
    },
    {
      "type": "enemy",
      "x": 200,
      "y": 128,
      "patrolMinX": 168,
      "patrolMaxX": 216
    },
    {
      "type": "enemy",
      "x": 280,
      "y": 64,
      "patrolMinX": 240,
      "patrolMaxX": 312
    },
    {
      "type": "powerup",
      "kind": "shovel",
      "x": 184,
      "y": 60
    },
    {
      "type": "powerup",
      "kind": "pickaxe",
      "x": 88,
      "y": 92
    }
  ]
}
